,-----.                ,--.                      ,--.                  
|  |) /_ ,--.--. ,---. |  |,-. ,---. ,--,--,     |  |    ,---.  ,---.  
|  .-.  \|  .--'| .-. ||     /| .-. :|      \    |  |   | .-. :| .-. | 
|  '--' /|  |   ' '-' '|  \  \\   --.|  ||  |    |  '--.\   --.' '-' ' 
`------' `--'    `---' `--'`--'`----'`--''--'    `-----' `----'.`-  /  
                                                               `---'  
This Program cant run :'(

Make it  run again by giving it the correct permission!
